08 February 2021 Alisa
Начать - to start
Говорить с ними - talk to them
Тепло - warm
Путешествовать - to travel
Поход - hiking
Позавчера - before yesterday
Позже - later
С другими друзьями 
С друзьями
Природа -nature
Разные страны 
Граница - border
2 дня назад - 2 days ago
На севере - on the North
Менее - less
Закончить - to finish
Разговор, беседа - conversation
Слушаю - i listen
Темы - topics
Необходимые - necessary
Произношение 
Заниматься
Заниматься спортом
Заниматься русским
Псени - songs
 


05 February 2021 Julia

На чём ты играешь?
Как что часто ты играешь на пианино? - how often
World - мир
Folk music - народная музыка
Классическая музыка
Я познакомился - I met (my friend)
Я познакомился с другом в школе.
Мы едим где-нибудь
Мексиканская еда
Ресторан называется Pedro’s
Мы ходим есть в Pedro’s
Когда я встречаюсь с этой подругой, мы идём в Pedro’s.

02 February 2021 Nastya
Обычно - usually
Учить - study
Просыпаться - wake up
После - after
Смотреть телевизор - watch TV
Друзья - friends
Суббота - Saturday
Воскресенье - Sunday
Звонить - to call
Звать - to call | to invite 
Магазин - a shop
Плавать - swim
Горы - mountains
Пустыня - desert
Делать фотографии / фотографировать - take a photo
Природа - the nature
Помогать - to help
Социальный работник - social worker
Охранник - security guard
Готовить - to cook
Путешествовать - to travel
Гулять - to walk
Электрик - electrician 
Водить - to drive (a car)
Около - near
Лес - forest
Дорого - expensive
Год - year

29 January 2021 Vitaliy
Tooth - зуб
Делать - to do / to make 
Недавно - recently 
Старшая сестра 
Сосед - neighbour / roommate / housemate 
Сосед по комнате / сосед по дому 
Команда - team
У моей сестры нет семьи сейчас
Гулять - to walk
Иногда я гуляю с ней
У нее есть характер 
Потому что - because 
Душа - soul
Как у кота - as a cat 


26 January 2021 Natasha 
Комната - room 
Номер в отеле 
Картина - painting 
Рисовать - to draw
Сейчас - now 
Беспорядок - mess 
Кровать - bed 
Другой - another 
Более красивый - more beautiful 
Больше (книг) - more 
Немецкий - german 
Город - города
Место - place 
Любимый - favourite 
Берег - coast 
Пойти - to go 
Кинотеатр 
Стадион
Библиотека 
22 January 2021 Vitaliy
Встреча - meeting
Встретил - met
Сосед - neighbour 
Вещь - thing вещи - things 
Наука - science 
Мир - world 
World history - мировая история 
Регион - region
Страна - country 
Middle East - ближний Восток

Предложить - to suggest
Квас 
Сладкий - sweet
Напиток - a drink
Вкусно - tasty

Пробовать - to try
Кушать - to eat 
Бабушка родилась 
Родиться - to be born







20 January 2021 Vitaliy
Как дела? - How are you? 
Дело - 

Сколько тебе лет?
Сколько - how much / how many 

Мне …. года
32 - тридцать два

Where are you from? Откуда ты? 
I’m from... - Я из…

Where do you live? - Где ты живешь?
I live in… - Я живу в… 

Классно! - Great!

Я живу во Львов+е 

Where do you work? - Где ты работаешь?
I work … - Я работаю в IT. / Я - программист. 

What do you like to do? - Что ты любишь делать?
I like…. - Я люблю читать книги, играть на фортепиано (пианИно) и программировать (писать код).

What kind of history? - Какую (историю)?

Спасибо за разговор (диалог). 
Увидимся на следующем уроке.


08 January 2021 Nastya M.
Lesson: Trial Lesson
Topic: Meeting new tutor


Восемь - 8
Друзья - friends
Еда - food
Икра - roe

 
Animals - животные
Весёлый - funny
Посещать - to visit
Этаж - floor

Цвет - colour
Красный - red
Чёрный - black
Коричневый - brown

Я предпочитаю - I prefer
Всегда - always
Не важно - not important
Невозможно - impossible

Солнечно - sunny
Холодно - cold
Жарко - hot
Градус - degree
Плюс - +
Минут - –
Цельсия - С
Фаренгейт - F
Плюс шесть градусов по Цельсию
Сорок четыре (44) градуса по Фаренгейту